1111100000000000000000000011111
1000000000000000000000000000001
1000000000000000000000000000001
1000000000000000000000000000001
1000000000000001000000000000001
1000000000000001000000000000001
1000000000000001000000000000001
1000000000000001000000000000001
1000011111111111111111111000001
1000000000000001000000000000001
1000000000000001000000000000001
1000000000000001000000000000001
1000000000000001000000000000001
1000000000000000000000000000001
1000000000000000000000000000001
1000000000000000000000000000001
1111100000000000000000000011111